strabiliante=astonishing
astronomico=astronomical
attraente=attractive
mozzafiato=breathtaking
suggestivo=evocative
che fa sentire piccoli=humbling
imponente=impressive
costruito dall'uomo=man-made
misterioso=mysterious
meritevole=overrated
viaggio di lavoro=business trip
sala conferenza=conference room
hotel di lusso=luxury hotel
viaggio con pernottamento=overnight journey
sacro=sacred
spettacolare=spectacular
sorprendente=surprising
all'estero=abroad
sistemazione=accomodation
preparativi=arrangements
galleria d'arte=art gallery
zaino=backpack
escursionista=backpacker
prenotare=book
noioso=boring
campeggio=campsite
agente di viaggio=travel agent
agenzia di viaggio=travel agency
preparativi di viaggio=travel arrangements
depliant di viaggio=travel brochure
budget di viaggio=travel budget
assicurazione viaggio=travel insurance
cattedrale=cathedral
cosmopolita=cosmopolitan
patrimonio culturale=cultural heritage
gita=excursion
fare autostop=hitch
assicurazione=insurance
viaggio=journey
vivace=lively
piazza=square
turistico=turisty
viaggio=trip
che vale la pena visitare=worth visiting
fuori dai sentieri battuti=off the beaten track
ristrettezze economiche=on a budget
castello=castle
chiesa=church
museo=museum
ristorante=restaurant
discoteca=nightclub
camminare=walking
trekking=trekking
folla=crowd
tormenta=thunderstorm
ridicolo=silly
